1111111111111111
1000011100000011
1000011100000011
1000011000000011
1000000000000011
1000000011100011
1111111111111111
